CHÀO HỎI
hola 	chào
buenos dias	chào buổi sáng
buenos tardes	chào buổi chiều
buenos noches	chào buổi tối
¿Como estas?	Bạn khỏe không?
Bien, gracias	Khỏe (tốt), cảm ơn
No estro y bien, gracias	Không khỏe lắm, cảm ơn
genial	tuyệt
bien	tốt
todo bien	tốt/vâng
más o menos	tàm tạm
mal	tệ
¿Como te llamos?	Tên bạn là gì?
Me llamo <…>	Tôi tên <…>
hasta pronto/hasta luego	gặp bạn sau
adiós	tạm biệt
cuídate/cuidaos	bảo trọng/giữ gìn sức khỏe
¿Y tú?	Còn bạn?
Gusto de conocerte	rất vui được gặp bạn
Encantado de conocerte	rất vui được gặp bạn
hace tiempo	lâu lắm rồi
¿Hablas español?	Nói tiếng Tây Ban Nha được không?
Puedo hablar un poco de español	Tôi bíết mốt chút tiếng Tây Ban Nha
No puedo hablar español	Tôi không bíết tiếng Tây Ban Nha
Soy de <pais>	Tôi đến từ <quốc gia>
¿Cuantos años tienes?	Bạn bao nhiêu tuổi?
Tengo <…> años	Tôi <…> tuổi

HỘI THOẠI
sí	vâng/được
no	no
¿Entiendes?	Hiểu không?
No entirndo	Không hiểu
entiendo	hiểu
gracias	cảm ơn
por favor	làm ơn
lo siento	xin lỗi
Repita, por favor	Làm ơn nói lại lần nữa
¿Puedes repetirlo?	Có thể nói lại lần nữa không?
Hable más despacio	Nói chậm hơn
estoy bien	không sao/khỏe
no lo sé	không biết
no me gusta	không thích nó
me gusta	thích nó/thích
de nada	không có chi/không có gì
con mucho gusto	không có chi/không có gì
entiendo que …	(tôi) hiểu là …
me gustaria/quiero …	(tôi) muốn …
¿Puedo usar tu teléfono?	Có thể dùng điện thoại?
¿Estas seguro?	Chắc không?
¿Qué significa esto?	(Nó) có nghĩa gì?
¿Cómo pronuncias esto?	(Từ) này phát âm như thế nào?
¿Puedes escribir cómo se dice?	Có thể viết cho tôi cách nói từ đó không?
¿Puedes escribir eso en español?	Có thể viết (từ) đó bằng tiếng Tây Ban Nha không?
no, gracias	không, cảm ơn
no, eso está mal	không, đó sai rổi
eso es/correcto	đó đúng/đúng
ningún problema	không có vấn đề/không có gì
¡Socorro!/¡Auyda!	Cứu!
¿Quién?	Ai?
¿Qué?	Cái gì?
¿Cuántos?	Bao nhiêu?
¿Cuánto?	Bao nhiêu tiền?
¿Por cuánto [tiempo]?	Bao lâu [thời gian]?
¿Cómo?	Như thế nào?
¿Por qué?	Tại sao?
¿Por qué no?	Tại sao không?
¿Cuál?	Cái nào?
¿Cuále?	Cái nào?
¿Dónde?	Ở đâu?
¿Cuándo?	Khi nào?
¿Hay?	Có?
¿Qué es esto?	Cái này là gì?
¿De quién es esto?	Cái này của ai?
¿Cuánto cuesta esto?	Cái này bao nhiêu tiền? (Cái này giá bao nhiêu?)
¿Qué haces?	(bạn) Đang làm gì đây?
¿Qué quieres?	(bạn) Muốn gì?
¿A dónde vas?	(bạn) đi đâu?
¿A dónde vamos?	Chúng tôi đi đâu?
voy a …	đi đến …
vamos a …	chúng tôi di …
¿Qué pasa ahora?	Cái gì đang xảy ra?
¿Cuándo es tu cumpleaños?	Khi nào ngày sinh nhật (của bạn)?
No olvides …	Đừng quên …
perdón	xin lỗi
antes	trước
después	sau
hasta	cho đến khi
Quiero ir de compras antes de ver la película	(Tôi) muốn đi mua sắm trước khi xem phim
Veré una película después de comprar	(Tôi) sẽ xem phim sau khi đi mua sắm
No tengo que ir sino hasta mañana	(Tôi) không phải đi đâu cho đến ngày mai
¿Vives aquí?	(Bạn) ở đây không?
¿Te gusta vivir aquí?	(Bạn) thích ở đây không?
Me gusta vivir aquí	(Tôi) thích ở đây
Estoy aquí de vacaciones	Tôi đến đây nghỉ lễ
de negocios	cho công tác
por trabajar	để làm việc
por estudio	để học
es broma	đùa thôi mà
es la primera vez que estoy aquí	lần đầu tiên đến đây
estamos de luna de miel	chúnh tôi đang nghỉ tuần trăng mật

SỐ
cero	không
uno	một
dos	hai
tres	ba
cuatro	bốn
cinco	năm
seis	sáu
siete	bảy
ocho	tám
nueve	chín
diez	mười
once	mười một
doce	mười hai
trece	mười ba
catorce	mười bốn
quine	mười lăm
dieciséis	mười sáu
diecisiete	mười bảy
dieciocho	mười tám
diecinueve	mười chín
veinte	hai mươi
veintiuno	hai mươi mốt
veintidós	hai mươi hai
veintitrés	hai mươi ba
veinticuatro	hai mươi bốn
veinticinco	hai mươi lăm
veintiséis	hai mươi sáu
veintisiete	hai mươi bảy
veintiocho	hai mươi tám
veintinueve	hai mươi chín
treinta	ba mươi
cuarenta	bốn mươi
cincuenta	năm mươi
sesenta	sáu mươi
setenta	bảy mươi
ochenta	tám mươi
noventa	chín mươi
cien	một trăm
mil	một ngàn
diezmil	mười ngàn
cienmil	trăm ngàn
un millón	một triệu

primero(a)	đầu tiên/thứ nhất
segundo(a)	thứ hai
tercero(a)	thứ ba
cuarto(a)	thứ tư
quinto(a)	thứ năm
sexto(a)	thứ sáu
séptimo	thứ bảy
octavo(a)	thứ tám
noveno(a)	thứ chín
décimo(a)	thứ mười

THỜI GIAN
¿Qué hora es?	Mấy giờ?
Son las 10 en punto	Bây giờ là 10 giờ
Son las 10 y media	Bây giờ là 10 giờ rưỡi
10 y carto	Bây giờ là 10 giờ 15 phút 
Cuarto para las 10	Bây giờ là 10 giờ kém 15
A.M.	sáng (trước 12 chưa)
P.M.	chiều/tối (sau 12 chưa)
una hora	một tiếng đồng hồ
media hora	nửa tiếng đồng hồ
cinco minutos	năm phút
dos segundos	hai giây
¿A qué hora empieza?	Mấy giờ thì bắt đầu?
Empieza a las 9	Bắt đầu lúc 9 giờ
¿Cuántas horas durará?	Sẽ séo dài mấy tiếng?
¿Cuántos días durará?	Sẽ séo dài mấy ngày?
medianoche	nửa đêm (12 giờ khuya)
las doce de el mediodía	buổi trưa (12 giờ trưa)
hoy	hôm nay
ayer	hôn qua
mañana	ngày mai
pasado mañana	ngày kia
esta noche	tối nay
mañana	buổi sáng
tarde	buổi chiều
noche	buổi tối
ahora	bây giờ
pronto	sớm
¿Qué día es hoy?	Hôm này là ngày thứ mấy?

lunes	thứ hai
martes	thứ ba
miércoles	thứ tư
jueves	thứ năm
viernes	thứ sáu
sábado	thứ bảy
domingo	chủ nhật

¿En qué mes estamos?	Bây giờ là tháng mấy?

enero	tháng một
febrero	tháng hai
marzo	tháng ba
abril	tháng tư
mayo	tháng năm
junio	tháng sáu
julio	tháng bảy
agosto	tháng tám
setiembre	tháng chín
octubre	tháng mười
noviembre	tháng mười một
diciembre	tháng mười hai

seta semeja	tuần này
la semana pasada	tuần trước
la semana próxima	tuần sau
este mes	tháng này
el mes pasado	tháng trước
el próximos mes	tháng sau
este año	năm này
el año pasado	năm trước
el próximo año	năm sau

estaciones	mùa
primavera	mùa xuân
verano	mùa hè
otoño	mùa thu
invierno	mùa đông
los monzones	mùa mưa

ĐỊA ĐIỂM
¿Donde está?	Đây là ở đây?
¿Esta lejos?	(Nó) bao xa?
¿Cómo llego?	Làm sao tới?
señalemelo en el mapa	chỉ giùm trong bản đồ
norte	phía bắc
sur	phía nam
este	phía đông
oeste	phía tây
cruce la calle	đi qua đường
izquierda	trái
derecha	phải
gira a la izquierda	rẽ trái
gira a la derecha	rẽ phải
arriba	lên
abajo	xuống
todo recto	đi thẳng
frente a	ở phía trước
detrás	ở phía sau
debajo	phía dưới
sobre	phía trên
opuesto(a)	đối diện
cerca (de)	gần
lejos (de)	xa
en la esquina	phía góc
más adelante	ngay đẳng trước kia
aqua	đây
allí	đó
semáforo	tin hiệu giao thông
cruce	ngã tư
aeropuerto	sân bay
parada de autobús	trạm xe buýt
estación de tren	trạm xe lửa
información turística	thông tin du lịch
gran alamacen	của hàng bách hóa/siêu thị


https://www.youtube.com/watch?v=fyc24YtDBhM
